++++++++++++++++++++++++++++++++++++++++++++++++++++++++++++++++++++++++++
++++++++++++++++++++++++++++++++++++++++++++++++++++++++++++++++++++++++++
++@.........++..........................................................++
++..........++..........................................................++
++..........++..........................................................++
++......++++++..........................................................++
++......++++++..........................................................++
++......................................................................++
++......................................................................++
++......................................................................++
++++++++++++++..........................................................++
++++++++++++++..........................................................++
++......................................................................++
++......................................................................++
++......................................................................++
++......................................................................++
++......................................................................++
++++++++++++++++++++++++++++++++++++++++++++++++++++++++++++++++++++++++++
++++++++++++++++++++++++++++++++++++++++++++++++++++++++++++++++++++++++++
