++++++++++++++++++++++++++++++++++++++++++++++++++++++++++++++++++++++++++
++++++++++++++++++++++++++++++++++++++++++++++++++++++++++++++++++++++++++
++..........++.................................++.......................++
++..........++.................................++.......................++
++..........++.................................++.......................++
++Ddd+++++++++.................................++.......................++
++ddd+++++++++.............@...................++.......................++
++.............................................++.......................++
++.............................................+........................++++++
++...............................++++..........+............................++
++++++++++++++Ddd+++.............++++..........++...........................++
++++++++++++++ddd+++.............++++..........++...........................++
++................++....................................................++++++
++................++....................................................++
++................++....................................................++
++................++....................................................++
++................++....................................................++
++++++++++++++++++++++++++++++++++++++++++++++++++++++++++++++++++++++++++
++++++++++++++++++++++++++++++++++++++++++++++++++++++++++++++++++++++++++
