++++++++++++++++++++++++++++++++++++++++++++++++++++++++++++++++++++++++++
++++++++++++++++++++++++++++++++++++++++++++++++++++++++++++++++++++++++++
++..........++.................................++.......................++
++..........++.................................++.......................++
++..........++.................................++.......................++
++......++++++.................................++.......................++
++......++++++.............@...................++.......................++
++.............................................++.......................++
++.............................................+........................++++++
++...............................++++..........+............................++
++++++++++++++...................++++..........++...........................++
++++++++++++++...................++++..........++...........................++
++......................................................................++++++
++......................................................................++
++......................................................................++
++......................................................................++
++......................................................................++
++++++++++++++++++++++++++++++++++++++++++++++++++++++++++++++++++++++++++
++++++++++++++++++++++++++++++++++++++++++++++++++++++++++++++++++++++++++
